50 50
##################################################
#.........#...................########...........#
#.........#...................########...........#
#.........#...................########........#..#
#..............#..............########........#..#
#..............#.................#####........#..#
#..............#.................#####........#..#
#.........#....################..#####........#..#
#.........#....################..#####........#..#
#.........#....################...............#..#
####..#####....################...............#..#
####..#####....################################..#
#.........#................................####..#
#.........#................................####..#
#.........#................................####..#
#.........#....################............####..#
#.........#...................#............####..#
#.........#...................#............####..#
#.........#...................#............####..#
#.........#...................#..................#
#..########...................#..................#
#..########...................##########...#######
#..########...................#######.........####
#..########...................#######.........####
#..########...................#######.........####
#..########...................#######.........####
#..########...................#######.........####
#..########...................#######.........####
#.............................#######.........####
#.............................#######.........####
#..##################################.........####
#..###############################............####
#..#........................######............####
#..#........................######..#..###########
#...........................######..#..###########
#...........................######..#..###########
####................................#............#
####................................#............#
####................####################.........#
####..##################............####.........#
#........#..........................####.........#
#........#..........................####.........#
#........#.......#######............####.........#
#........#.......#######............####.........#
#........#.......#######...####################..#
#........#.......#..................###########..#
#........#.......#..................###########..#
#................#...............................#
#................#...............................#
##################################################
